###################################
# Verge of Domination Custom Tags #
###################################
# Soviet Factions
SOV = "countries/Soviet Union.txt"
POL = "countries/Soviet Poland.txt" # Soviet Occupied Poland
PRC = "countries/Soviet China.txt" # Soviet Occupied China
GER = "countries/Soviet Germany.txt" # Soviet Occupied Germany
WPR = "countries/Soviet West Prussia.txt"
EPR = "countries/Soviet East Prussia.txt"
BOH = "countries/Soviet Bohemia.txt"
AUS = "countries/Soviet Austria.txt"
BSL = "countries/Soviet Breslau.txt"
EGY = "countries/Soviet Egypt.txt"
HUN = "countries/Soviet Hungary.txt"
ZAG = "countries/Soviet Zagreb.txt"
ITA = "countries/Soviet Italy.txt"
UKR = "countries/Soviet Ukraine.txt"
LIB = "countries/Soviet Libya.txt"
TRS = "countries/Soviet Trieste.txt"
SER = "countries/Soviet Serbia.txt"
ALB = "countries/Soviet Albania.txt"
LIT = "countries/Soviet Lithuania.txt"
BEL = "countries/Soviet Belarus.txt"
DEN = "countries/Soviet Denmark.txt"
WAL = "countries/Soviet Wallachia.txt"
MOL = "countries/Soviet Moldavia.txt"
KOR = "countries/Soviet Korea.txt"
BUL = "countries/Soviet Bulgaria.txt"
FIN = "countries/Soviet Finland.txt"
SWE = "countries/Soviet Sweden.txt"
NOR = "countries/Soviet Norway.txt"
GEO = "countries/Soviet Georgia.txt"
ARM = "countries/Soviet Armenia.txt"
PER = "countries/Soviet Persia.txt"
ARB = "countries/Soviet Arabia.txt"
VIN = "countries/Soviet Vietnam.txt"
ISR = "countries/Soviet Israel.txt"
SYR = "countries/Soviet Syria.txt"
BRM = "countries/Soviet Burma.txt"
LAO = "countries/Soviet Laos.txt"
AZE = "countries/Soviet Azerbaijan.txt"
BAN = "countries/Soviet Bengal.txt"
TUR = "countries/Soviet Turkey.txt"
TRM = "countries/Soviet Anatolia.txt"
SOM = "countries/Soviet Somalia.txt"
ETH = "countries/Soviet Ethiopia.txt"
BLN = "countries/Soviet Blue Nile.txt"
KUR = "countries/Soviet Kurdistan.txt"
AFG = "countries/Soviet Afghanistan.txt"
PUN = "countries/Soviet Punjab.txt"
MON = "countries/Soviet Mongolia.txt"
TUV = "countries/Soviet Tuva.txt"
PAK = "countries/Soviet Pakistan.txt"
JAV = "countries/Soviet Sumatra.txt"
ERT = "countries/Soviet Eritrea.txt"
KAZ = "countries/Soviet Kazakhstan.txt"
UZB = "countries/Soviet Uzbekistan.txt"
TAJ = "countries/Soviet Tajikistan.txt"
MND = "countries/Soviet Mandalay.txt"
TAI = "countries/Soviet Thailand.txt"
DEL = "countries/Soviet Delhi.txt"
TRK = "countries/Soviet Turkistan.txt"
IRQ = "countries/Soviet Iraq.txt"
YEM = "countries/Soviet Yemen.txt"
OMA = "countries/Soviet Oman.txt"
BAD = "countries/Soviet Badlands.txt"
ARB = "countries/Soviet Arabia.txt"
CHE = "countries/Soviet Chechnya.txt"
# American Factions
USA = "countries/USA.txt"
CIA = "countries/USA CIA.txt"
ONT = "countries/USA Ontario.txt"
BAJ = "countries/USA Baja California.txt"
USE = "countries/USA Europe.txt"
USG = "countries/USA North Africa.txt"
USC = "countries/USA Central Africa.txt"
USS = "countries/USA South Africa.txt"
USV = "countries/USA South America.txt"
USM = "countries/USA Central America.txt"
MEX = "countries/USA Mexico.txt"
CAN = "countries/USA Canada.txt"
QEB = "countries/USA Quebec.txt"
BRA = "countries/USA Brazil.txt"
GUS = "countries/USA Guyana.txt"
CAP = "countries/USA Cape.txt"
FRA = "countries/USA France.txt"
ENG = "countries/USA Britain.txt"
JAP = "countries/USA Japan.txt"
CUB = "countries/USA Cuba.txt"
SWI = "countries/USA Switzerland.txt"
CAR = "countries/USA Central America.txt"
BCM = "countries/USA British Columbia.txt"
DOM = "countries/USA Dominican Republic.txt"
# Rebel Factions
REB = "countries/Rebel wasteland.txt" # Rebel Wastelands (Territories controlled by armed rebel groups which is unable to be conquered)
NUC = "countries/Nuclear wasteland.txt" # Nuclear Wastelands (Territories completely destroyed)

# Unused TAGs
MAN = "countries/Unused.txt"
MEN = "countries/Unused.txt"
CHI = "countries/Unused.txt"